#
LEVEL 1 
#

-
0011111100
0112222110
0033223300
0111111110
0112222110
0110000110
0331111330
0220000220
0100110010
0110000110
-

!
___>>_<___
__________
______+___
__________
___+______
______+___
__________
__^____+__
_>__^>__>_
__________
!
